0000000000
0000330000
0001331000
0012332100
0122222210
0122222210
1222222221
2222112222
2222332222
2222332222
1222222221
4110110114
4100110014
4101441014
4101441014
4141441414
1144444411
0141111410
0014114100
0001441000
0000110000
